SSSSSSSSSSSSSSSSSSSSSSSSSSSSSSSS
SX  BB BBBB S BBBSBBBB S  BB  BS
S S SBSBS  SBS B SBSBS BB SS B S
S S BBBSBBBBB SBSBBBBSBBBB BSSSS
SSBBSBSBSBSBSBSB BSBSBBBSBSBSBBS
SB BBBBBBB SBBBSBBSBB SS BBB SBS
SBSSS SBSBSBSSB SBS BSBS S S BBS
SBB BB SBBBBBBB SBSS  S BBBBB SS
SBSBSBSBSBS  S B  BBSBSBSBSSS  S
SS  B B B BB S SSS BB S SB S BBS
S SBSBSBSBBBSS SSSBSBSBSBSBSBSBS
S B BBB  S BBB S BBB  B BBB BB S
S  BBB  BS  SBBS   BBB  BBB S YS
SSSSSSSSSSSSSSSSSSSSSSSSSSSSSSSS
