SSSSSSSSSSSSSSSSSSSSSSSSSSSSSSSSSSSSSSSSSSSSSSSSSSSSSSSSSSSSSSSSSSSSSSSSS
SXBSS             BSS             BSS         BSS                 BSS BSS
S BSS BSSSSSSSSSS BSS BSSSSSS BSSSSSSSSSS BSSSSSS BSSSSSS BSSSSSS BSS BSS
S             BSS     BSS BSS         BSS         BSS BSS BSS     BSS BSS
SSSSSSSSS BSS BSSSSSSSSSS BSSSSSSSSSS BSSSSSS BSS BSS BSS BSSSSSSSSSS BSS
S     BSS BSS             BSS         BSS BSS BSS BSS BSS         BSS BSS
S BSS BSSSSSSSSSSSSSS BSS BSS BSSSSSSSSSS BSSSSSS BSS BSSSSSSSSSS BSS BSS
S BSS             BSS BSS BSS     BSS         BSS         BSS     BSS BSS
S BSSSSSSSSSSSSSS BSSSSSS BSSSSSS BSS BSSSSSS BSSSSSSSSSS BSS BSSSSSS BSS
S         BSS     BSS BSS     BSS BSS     BSS         BSS BSS         BSS
S BSSSSSS BSSSSSS BSS BSSSSSS BSS BSSSSSSSSSS BSS BSS BSS BSSSSSSSSSSSSSS
S     BSS     BSS BSS BSS     BSS     BSS     BSS BSS BSS     BSS     BSS
SSSSSSSSSSSSS BSS BSS BSS BSSSSSSSSSS BSS BSSSSSS BSS BSSSSSS BSSSSSS BSS
S         BSS BSS         BSS     BSS BSS     BSS BSS     BSS         BSS
S BSSSSSS BSS BSSSSSSSSSS BSSSSSS BSS BSSSSSS BSSSSSS BSSSSSSSSSSSSSS BSS
S BSS     BSS         BSS         BSS     BSS BSS BSS             BSS BSS
S BSS BSSSSSSSSSS BSS BSSSSSS BSSSSSSSSSS BSS BSS BSSSSSSSSSSSSSS BSS BSS
S BSS         BSS BSS BSS BSS BSS         BSS             BSS BSS     BSS
S BSSSSSSSSSS BSS BSS BSS BSSSSSS BSSSSSSSSSS BSSSSSSSSSS BSS BSSSSSSSSSS
S BSS     BSS BSS BSS         BSS         BSS BSS     BSS             BSS
S BSS BSSSSSS BSSSSSS BSSSSSS BSSSSSSSSSS BSSSSSS BSS BSSSSSSSSSS BSS BSS
S BSS                 BSS         BSS             BSS             BSSYBSS
SSSSSSSSSSSSSSSSSSSSSSSSSSSSSSSSSSSSSSSSSSSSSSSSSSSSSSSSSSSSSSSSSSSSSSSSS
